#########################
#  H   B   H       H    #
#S H   G   H   C   H  D #
###H#######H#######H#####
#  H       H  V    H    #
#  H D     H  V    H    #
###H#######H##V####H#####
#  H       H  V    H    #
#  H   C   H  V    H  D #
###H#######H##V####H#####
#  H       H  V    H    #
#  H   C   H  V G  H    #
###H#######H#######H#####
#  H       H       H    #
#  H D W ^ H B K   H  E #
#########################

SPAWNS 0 3 0 2
