##################################################
#   H       H  V    H        H   O   H  V    H   #
#E TH   G   H  VC   H  D     H   G   H  VC   H  D#
####H#######H##V####H########H#######H##V####H####
#   H       H  V    H        H       H  V    H   #
# D H  T    H  VC   H      D H       H  VC   H   #
####H#######H#######H########H#######H#######H####
#   H       H   B   H    O   H       H       H   #
#   H   C   H     D H   T    H   C   H     D H   #
####H#######H#######H########H#######H#######H####
#   H       H       H        H       H    O  H   #
# D H   C   H   G   H      D H   C   H T G   H N #
####H###FFF#H#FFF###H##  P ##H###FFF#H#FFF###H####
#   H       H       H        H       H       H   #
#   H   X   H   C   H   ^ K  H   X   H B C   H S #
##################################################

SPAWNS 0 2 0 2 0 0 0 0
