#########################
#  H   B   H    O  H    #
#S H d G c H   C   HT Di#
###H#######H#######H#####
#  H   O   H  V    H    #
#  H D  J  Hi V T  Hd   #
###H#######H##V####H#####
#  H       H  V    H    #
#  H d C c H  V    H  D #
###H#######H##V####H#####
#  H       H  V    H    #
#  H   C T Hi V G  H d c#
###H#######H#######H#####
#  H       H    O  H    #
#  H D W ^ H B K i H  E #
#########################

SPAWNS 0 3 0 2
