#########################
#  H   B   H    O  H    #
#S H d G c H   C   HT Di#
###H#######H#######H#####
#  H   O   H  V    H    #
#  H DL J  Hi V T  Hd   #
###H#######H##V####H#####
#  H       H  V    H    #
#  H d C c H  V    H LD #
###H#######H##V####H#####
#  H       H  V    H    #
#  H   C T Hi V G  H d c#
###H#######H#######H#####
#  H       H    O  H    #
#  H D WL^ H B K i H  E #
#########################

SPAWNS 0 3 0 2
