.......................
.......................
.......................
.......................
.......................
#######################
#                     #
#                     #
#                     #
#RS  o z o G N K b b  #
#######################
